!SnakeGame/Map1.txt
!Map = 40X40
!0 = blank
!1 = Snake1
!2 = Snake2
!3 = Wall
!4 = Obstacle
0000000000000000000000000000000000000000
0000000000000000000000000000000000000000
3333333333333333333333333333333333333333
3000000000000000000000000000000000000003
3000000000000000000000000000000000000003
3000000000000000000000000000000000000003
3000000000000000000000000000000000000003
3000000000000000000000000000000000000003
3000000000000000000000000000000000000003
3000000000000000000000000000000000000003
3000000000000000000200000000000000000003
3000044444444440000000000444444444400003
3000040000000000000000000000000000400003
3000040000000000000000000000000000400003
3000040000000000000000000000000000400003
3000040000000000000000000000000000400003
3000040000000000000000000000000000400003
3000000000000000000000000000000000000003
3000000000000000000000000000000000000003
3000000000000000000000000000000000000003
3000000000000000000000000000000000000003
3000000000000000000000000000000000000003
3000000000000000000000000000000000000003
3000000000000000000000000000000000000003
3000000000000000000000000000000000000003
3000040000000000000000000000000000400003
3000040000000000000000000000000000400003
3000040000000000000000000000000000400003
3000040000000000000000000000000000400003
3000040000000000000000000000000000400003
3000044444444440000000000444444444400003
3000000000000000000100000000000000000003
3000000000000000000000000000000000000003
3000000000000000000000000000000000000003
3000000000000000000000000000000000000003
3000000000000000000000000000000000000003
3000000000000000000000000000000000000003
3000000000000000000000000000000000000003
3000000000000000000000000000000000000003
3333333333333333333333333333333333333333