!SnakeGame/Map2.txt
!Map = 40X40
!0 = blank
!1 = Snake1
!2 = Snake2
!3 = Wall
!4 = SpikeBall
!5 = Snake 3
!6 = Snake 4
!7 = Snake 5
!8 = Snake 6
0000000000000000000000000000000000000000
0000000000000000000000000000000000000000
3333333333333333333333333333333333333333
3100300000003000000330000003000000030053
3000300000003000000330000003000000030003
3000300000003000000330000003000000030003
3000300030003000300330030003000300030003
3000300030003000300330030003000300030003
3000300030003000300330030003000300030003
3000300030003000300330030003000300030003
3000300030003000300330030003000300030003
3000300030003000300330030003000300030003
3000300030003000300330030003000300030003
3000000030000000300330030000000300000003
3000000030000000300330030000000300000003
3000000030000000300330030000000300000003
3333333333333333300330033333333333333333
3000000000000000000330000000000000000003
3000000000000000000330000000000000000003
3004444444444444444334444444444444444003
3000000000000000000330000000000000000003
3333000000000000000330000000000000003333
3444444444444444400330044444444444444443
3000000000000000000330000000000000000003
3000000000000000000330000000000000000003
3000000000000000000330000000000000000003
3000000000000000000330000000000000000003
3000000000000000000330000000000000000003
3000000000000000000330000000000000000003
3000000000000000000330000000000000000003
3000000000000000000330000000000000000003
3000000000000000000330000000000000000003
3000000000000000000330000000000000000003
3000000000000000000330000000000000000003
3000000000000000000330000000000000000003
3000000000000004440330444000000000000003
3000000000000004440000444000000000000003
3000000000000004440000444000000000000003
3000000000000000000000000000000000000003
3333333333333333333333333333333333333333